¡à¡à¡à¡à¡à¡à¡à¡à¡à¡à¡à¡à¡à¡à¡à¡à¡à¡à¡à¡à¡à¡à¡à¡à¡à¡à¡à¡à¡à¡à¡à¡à¡à¡à¡à¡à¡à¡à¡à¡à¡à¡à¡à¡à¡à¡à¡à¡à¡à¡à¡à¡à¡à¡à¡à¡à¡à¡à¡à¡à¡à¡à¡à¡à¡à¡à¡à¡à¡à¡à¡à¡à¡à¡à¡à¡à¡à¡à¡à¡à¡à¡à¡à¡à¡à¡à¡à¡à¡à¡à¡à¡à¡à¡à¡à¡à¡à¡à¡à¡à
¡à¡à¡à¡à¡á¡á¡á¡á¡á¡á¡à¡à¡à¡à¡à¡à¡à¡à¡à¡à¡à¡à¡à¡à¡à¡à¡à¡à¡à¡à¡à¡à¡à¡à¡à¡à¡à¡à¡à¡à¡à¡à¡à¡à¡à¡à¡à¡à¡à¡à¡à¡à¡à¡à¡à¡à¡à¡à¡à¡à¡à¡à¡à¡à¡à¡à¡à¡à¡à¡à¡à¡à¡à¡à¡à¡à¡à¡à¡à¡à¡à¡à¡à¡à¡à¡à¡à¡à¡à¡à¡à¡à¡à¡à¡à¡à¡à¡à¡à¡à
¡à¡à¡à¡à¡á¡á¡á¡á¡á¡á¡à¡à¡à¡à¡à¡à¡à¡à¡à¡à¡à¡à¡à¡à¡à¡à¡à¡à¡à¡à¡à¡à¡à¡à¡à¡à¡à¡à¡à¡à¡à¡à¡à¡à¡à¡à¡à¡à¡à¡à¡à¡à¡à¡à¡à¡à¡à¡à¡à¡à¡à¡à¡à¡à¡à¡à¡à¡à¡à¡à¡à¡à¡à¡à¡à¡à¡à¡à¡à¡à¡à¡à¡à¡à¡à¡à¡à¡à¡à¡à¡à¡à¡à¡à¡à¡à¡à¡à¡à¡à
¡à¡à¡à¡à¡á¡á¡á¡á¡á¡á¡à¡à¡à¡à¡à¡à¡à¡à¡à¡à¡à¡à¡à¡à¡à¡à¡à¡à¡à¡à¡à¡à¡à¡à¡à¡à¡à¡à¡à¡à¡à¡à¡à¡à¡à¡à¡à¡à¡à¡à¡à¡à¡à¡à¡à¡à¡à¡à¡à¡à¡à¡à¡à¡à¡à¡à¡à¡à¡à¡à¡à¡à¡à¡à¡à¡à¡à¡à¡à¡à¡à¡à¡à¡à¡à¡à¡à¡à¡à¡à¡à¡à¡à¡à¡à¡à¡à¡à¡à¡à
¡à¡à¡à¡à¡à¡à¡à¡à¡à¡à¡à¡à¡à¡à¡à¡à¡à¡à¡à¡à¡à¡à¡à¡à¡à¡à¡à¡à¡à¡à¡à¡à¡à¡à¡à¡à¡à¡à¡à¡à¡à¡à¡à¡à¡à¡à¡à¡à¡à¡à¡à¡à¡à¡à¡à¡à¡à¡à¡à¡à¡à¡à¡à¡à¡à¡à¡à¡à¡à¡à¡à¡à¡à¡à¡à¡à¡à¡à¡à¡à¡à¡à¡à¡à¡à¡à¡à¡à¡à¡à¡à¡à¡à¡à¡à¡à¡à¡à¡à¡à
¡à¡à¡à¡à¡à¡à¡à¡à¡à¡à¡à¡à¡à¡à¡à¡à¡à¡à¡à¡à¡à¡à¡à¡à¡à¡à¡à¡à¡à¡à¡à¡à¡à¡à¡à¡à¡à¡à¡à¡à¡à¡à¡à¡à¡à¡à¡à¡à¡à¡à¡à¡à¡à¡à¡à¡à¡à¡à¡à¡à¡à¡à¡à¡à¡à¡à¡à¡à¡à¡à¡à¡à¡à¡à¡à¡à¡à¡à¡à¡à¡à¡à¡à¡à¡à¡à¡à¡à¡à¡à¡à¡à¡à¡à¡à¡à¡à¡à¡à¡à
¡à¡à¡à¡à¡à¡à¡à¡à¡à¡à¡à¡à¡à¡à¡à¡à¡à¡à¡à¡à¡à¡à¡à¡à¡à¡à¡à¡à¡à¡à¡à¡à¡à¡à¡à¡à¡à¡à¡à¡à¡à¡à¡à¡à¡à¡à¡à¡à¡à¡à¡à¡à¡à¡à¡à¡à¡à¡à¡à¡à¡à¡à¡à¡à¡à¡à¡à¡à¡à¡à¡à¡à¡à¡à¡à¡à¡à¡à¡à¡à¡à¡à¡à¡à¡à¡à¡à¡à¡à¡à¡à¡à¡à¡à¡à¡à¡à¡à¡à¡à
¡à¡à¡à¡à¡à¡à¡à¡à¡à¡à¡à¡à¡à¡à¡à¡à¡à¡à¡à¡à¡à¡à¡à¡à¡à¡à¡à¡à¡à¡à¡à¡à¡à¡à¡à¡à¡à¡à¡à¡à¡à¡à¡à¡à¡à¡à¡à¡à¡à¡à¡à¡à¡à¡à¡à¡à¡à¡à¡à¡à¡à¡à¡à¡à¡à¡à¡à¡à¡à¡à¡à¡à¡à¡à¡à¡à¡à¡à¡à¡à¡à¡à¡à¡à¡à¡à¡à¡à¡à¡à¡à¡à¡à¡à¡à¡à¡à¡à¡à¡à
¡à¡à¡à¡à¡à¡à¡à¡à¡à¡à¡à¡à¡à¡à¡à¡à¡à¡à¡à¡à¡à¡à¡à¡à¡à¡à¡à¡à¡à¡à¡à¡à¡à¡à¡à¡à¡à¡à¡à¡à¡à¡à¡à¡à¡à¡à¡à¡à¡à¡à¡à¡à¡à¡à¡à¡à¡à¡à¡à¡à¡à¡à¡à¡à¡à¡à¡à¡à¡à¡à¡à¡à¡à¡à¡à¡à¡à¡à¡à¡à¡à¡à¡à¡à¡à¡à¡à¡à¡à¡à¡à¡à¡à¡à¡à¡à¡à¡à¡à¡à
¡à¡à¡à¡à¡à¡à¡à¡à¡à¡à¡à¡à¡à¡à¡à¡à¡à¡à¡à¡à¡à¡à¡à¡à¡à¡à¡à¡à¡à¡à¡à¡à¡à¡à¡à¡à¡à¡à¡à¡à¡à¡à¡à¡à¡à¡à¡à¡à¡à¡à¡à¡à¡à¡à¡à¡à¡à¡à¡à¡à¡à¡à¡à¡à¡à¡à¡à¡à¡à¡à¡à¡à¡à¡à¡à¡à¡à¡à¡à¡à¡à¡à¡à¡à¡à¡à¡à¡à¡à¡à¡à¡à¡à¡à¡à¡à¡à¡à¡à¡à
¡à¡à¡à¡à¡à¡à¡à¡à¡à¡à¡à¡à¡á¡á¡á¡á¡á¡á¡à¡à¡à¡à¡à¡à¡à¡à¡à¡à¡à¡à¡à¡à¡à¡à¡à¡à¡à¡à¡à¡à¡à¡à¡à¡à¡à¡à¡à¡à¡à¡à¡à¡à¡à¡à¡à¡à¡à¡à¡à¡à¡à¡à¡à¡à¡à¡à¡à¡à¡à¡à¡à¡à¡à¡à¡à¡à¡à¡à¡à¡à¡à¡à¡à¡à¡à¡à¡à¡à¡à¡à¡à¡à¡à¡à¡à¡à¡à¡à¡à¡à
¡à¡à¡à¡à¡à¡à¡à¡à¡à¡à¡à¡à¡à¡à¡à¡à¡à¡à¡à¡à¡à¡à¡à¡à¡à¡à¡à¡à¡à¡à¡à¡à¡à¡à¡à¡à¡à¡à¡à¡à¡à¡à¡à¡à¡à¡à¡à¡à¡à¡à¡à¡à¡à¡à¡à¡à¡à¡à¡à¡à¡à¡à¡à¡à¡à¡à¡à¡à¡à¡à¡à¡à¡à¡à¡à¡à¡à¡à¡à¡à¡à¡à¡à¡à¡à¡à¡à¡à¡à¡à¡à¡à¡à¡à¡à¡à¡à¡à¡à¡à
¡à¡à¡à¡à¡à¡à¡à¡à¡à¡à¡à¡à¡à¡à¡à¡à¡à¡à¡à¡à¡à¡à¡à¡à¡à¡à¡à¡à¡à¡à¡à¡à¡à¡à¡à¡à¡à¡à¡à¡à¡à¡à¡à¡à¡à¡à¡à¡à¡à¡à¡à¡à¡à¡à¡à¡à¡à¡à¡à¡à¡à¡à¡à¡à¡à¡à¡à¡à¡à¡à¡à¡à¡à¡à¡à¡à¡à¡à¡à¡à¡à¡à¡à¡à¡à¡à¡à¡à¡à¡à¡à¡à¡à¡à¡à¡à¡à¡à¡à¡à
¡à¡à¡à¡à¡à¡à¡à¡à¡à¡à¡à¡à¡à¡à¡à¡à¡à¡à¡à¡à¡à¡à¡à¡à¡à¡à¡à¡à¡à¡à¡à¡à¡à¡à¡à¡à¡à¡à¡à¡à¡à¡à¡à¡à¡à¡à¡à¡à¡à¡à¡à¡à¡à¡à¡à¡à¡à¡à¡à¡à¡à¡à¡à¡à¡à¡à¡à¡à¡à¡à¡à¡à¡à¡à¡à¡à¡à¡à¡à¡à¡à¡à¡à¡à¡à¡à¡à¡à¡à¡à¡à¡à¡à¡à¡à¡à¡à¡à¡à¡à
¡à¡à¡à¡à¡à¡à¡à¡à¡à¡à¡à¡à¡à¡à¡à¡à¡à¡à¡à¡à¡à¡à¡à¡à¡à¡à¡à¡à¡à¡à¡à¡à¡à¡à¡à¡à¡à¡à¡à¡à¡à¡à¡à¡à¡à¡à¡à¡à¡à¡à¡à¡à¡à¡à¡à¡à¡à¡à¡à¡à¡à¡à¡à¡à¡à¡à¡à¡à¡à¡à¡à¡à¡à¡à¡à¡à¡à¡à¡à¡à¡à¡à¡à¡à¡à¡à¡à¡à¡à¡à¡à¡à¡à¡à¡à¡à¡à¡à¡à¡à
¡à¡à¡à¡à¡à¡à¡à¡à¡à¡à¡à¡à¡à¡à¡à¡à¡à¡à¡à¡à¡à¡à¡à¡à¡à¡à¡à¡à¡à¡à¡à¡à¡à¡à¡à¡à¡à¡à¡à¡à¡à¡à¡à¡à¡à¡à¡à¡à¡à¡à¡à¡à¡à¡à¡à¡à¡à¡à¡à¡à¡à¡à¡à¡à¡à¡à¡à¡à¡à¡à¡à¡à¡à¡à¡à¡à¡à¡à¡à¡à¡à¡à¡à¡à¡à¡à¡à¡à¡à¡à¡à¡à¡à¡à¡à¡à¡à¡à¡à¡à
¡à¡à¡à¡à¡à¡à¡à¡à¡à¡à¡à¡à¡à¡à¡à¡à¡à¡à¡à¡à¡à¡à¡à¡à¡à¡à¡à¡à¡à¡à¡à¡à¡à¡à¡à¡à¡à¡à¡à¡à¡à¡à¡à¡à¡à¡à¡à¡à¡à¡à¡à¡à¡à¡à¡à¡à¡à¡à¡à¡à¡à¡à¡à¡à¡à¡à¡à¡à¡à¡à¡à¡à¡à¡à¡à¡à¡à¡à¡à¡à¡à¡à¡à¡à¡à¡à¡à¡à¡à¡à¡à¡à¡à¡à¡à¡à¡à¡à¡à¡à
¡à¡à¡à¡à¡à¡à¡à¡à¡á¡á¡á¡á¡á¡á¡á¡á¡á¡á¡á¡á¡á¡á¡à¡à¡à¡à¡à¡à¡à¡à¡à¡à¡à¡à¡à¡à¡à¡à¡à¡à¡à¡à¡à¡à¡à¡à¡à¡à¡à¡à¡à¡à¡à¡à¡à¡à¡à¡à¡à¡à¡à¡à¡à¡à¡à¡à¡à¡à¡à¡à¡à¡à¡à¡à¡à¡à¡à¡à¡à¡à¡à¡à¡à¡à¡à¡à¡à¡à¡à¡à¡à¡à¡à¡à¡à¡à¡à¡à¡à¡à
¡à¡à¡à¡à¡à¡à¡à¡à¡á¡á¡á¡á¡á¡á¡á¡á¡á¡á¡á¡á¡á¡á¡à¡à¡à¡à¡à¡à¡à¡à¡à¡à¡à¡à¡à¡à¡à¡à¡à¡à¡à¡à¡à¡à¡à¡à¡à¡à¡à¡à¡à¡à¡à¡à¡à¡à¡à¡à¡à¡à¡à¡à¡à¡à¡à¡à¡à¡à¡à¡à¡à¡à¡à¡à¡à¡à¡à¡à¡à¡à¡à¡à¡à¡à¡à¡à¡à¡à¡à¡à¡à¡à¡à¡à¡à¡à¡à¡à¡à¡à
¡à¡à¡à¡à¡à¡à¡à¡à¡à¡à¡à¡à¡à¡à¡à¡à¡à¡à¡à¡à¡à¡à¡à¡à¡à¡à¡à¡à¡à¡à¡à¡à¡à¡à¡à¡à¡à¡à¡à¡à¡à¡à¡à¡à¡à¡à¡à¡à¡à¡à¡à¡à¡à¡à¡à¡à¡à¡à¡à¡à¡à¡à¡à¡à¡à¡à¡à¡à¡à¡à¡à¡à¡à¡à¡à¡à¡à¡à¡à¡à¡à¡à¡à¡à¡à¡à¡à¡à¡à¡à¡à¡à¡à¡à¡à¡à¡à¡à¡à¡à
¡à¡à¡à¡à¡à¡à¡à¡à¡à¡à¡à¡à¡à¡à¡à¡à¡à¡à¡à¡à¡à¡à¡à¡à¡à¡à¡à¡à¡à¡à¡à¡à¡à¡à¡à¡à¡à¡à¡à¡à¡à¡à¡à¡à¡à¡à¡à¡à¡à¡à¡à¡à¡à¡à¡à¡à¡à¡à¡à¡à¡à¡à¡à¡à¡à¡à¡à¡à¡à¡à¡à¡à¡à¡à¡à¡à¡à¡à¡à¡à¡à¡à¡à¡à¡à¡à¡à¡à¡à¡à¡à¡à¡à¡à¡à¡à¡à¡à¡à¡à
¡à¡à¡à¡à¡à¡à¡à¡à¡à¡à¡à¡à¡à¡à¡à¡à¡à¡à¡à¡à¡à¡à¡à¡à¡à¡à¡à¡à¡à¡à¡à¡à¡à¡à¡à¡à¡à¡à¡à¡à¡à¡à¡à¡à¡à¡à¡à¡à¡à¡à¡à¡à¡à¡à¡à¡à¡à¡à¡à¡à¡à¡à¡à¡à¡à¡à¡à¡à¡à¡à¡à¡à¡à¡à¡à¡à¡à¡à¡à¡à¡à¡à¡à¡à¡à¡à¡à¡à¡à¡à¡à¡à¡à¡à¡à¡à¡à¡à¡à¡à
¡à¡à¡à¡à¡à¡à¡à¡à¡à¡à¡à¡à¡à¡à¡à¡à¡à¡à¡à¡à¡à¡à¡à¡à¡à¡à¡à¡à¡à¡à¡à¡à¡à¡à¡à¡à¡à¡à¡à¡à¡à¡à¡à¡à¡à¡à¡à¡à¡à¡à¡à¡à¡à¡à¡à¡à¡à¡à¡à¡à¡à¡à¡à¡à¡à¡à¡à¡à¡à¡à¡à¡à¡à¡à¡à¡à¡à¡à¡à¡à¡à¡à¡à¡à¡à¡à¡à¡à¡à¡à¡à¡à¡à¡à¡à¡à¡à¡à¡à¡à
¡à¡à¡à¡à¡à¡à¡à¡à¡à¡à¡à¡à¡à¡à¡à¡à¡à¡à¡à¡à¡à¡à¡à¡à¡à¡à¡à¡à¡à¡à¡à¡à¡à¡à¡à¡à¡à¡à¡à¡à¡à¡à¡à¡à¡à¡à¡à¡à¡à¡à¡à¡à¡à¡à¡à¡à¡à¡à¡à¡à¡à¡à¡à¡à¡à¡à¡à¡à¡à¡à¡à¡à¡à¡à¡à¡à¡à¡à¡à¡à¡à¡à¡à¡à¡à¡à¡à¡à¡à¡à¡à¡à¡à¡à¡à¡à¡à¡à¡à¡à
¡à¡à¡à¡à¡à¡à¡à¡à¡à¡à¡à¡à¡à¡à¡à¡à¡à¡à¡à¡à¡à¡à¡à¡à¡à¡à¡à¡à¡à¡à¡à¡à¡à¡à¡à¡à¡à¡à¡à¡à¡à¡à¡à¡à¡à¡à¡à¡à¡à¡à¡à¡à¡à¡à¡à¡à¡à¡à¡à¡à¡à¡à¡à¡à¡à¡à¡à¡à¡à¡à¡à¡à¡à¡à¡à¡à¡à¡à¡à¡à¡à¡à¡à¡à¡à¡à¡à¡à¡à¡à¡à¡à¡à¡à¡à¡à¡à¡à¡à¡à
¡à¡à¡à¡à¡à¡à¡à¡à¡à¡à¡à¡à¡à¡à¡à¡à¡à¡à¡à¡à¡à¡à¡à¡à¡à¡à¡à¡à¡á¡á¡á¡á¡á¡á¡á¡á¡á¡á¡á¡á¡á¡á¡á¡á¡á¡á¡á¡á¡á¡á¡á¡á¡á¡á¡á¡á¡á¡á¡á¡á¡á¡á¡á¡á¡á¡á¡á¡á¡á¡à¡à¡à¡à¡à¡à¡à¡à¡à¡à¡à¡à¡à¡à¡à¡à¡à¡à¡à¡à¡à¡à¡à¡à¡à¡à¡à¡à¡à¡à¡à
¡à¡à¡à¡à¡à¡à¡à¡à¡à¡à¡à¡à¡à¡à¡à¡à¡à¡à¡à¡à¡à¡à¡à¡à¡à¡à¡à¡à¡á¡á¡á¡á¡á¡á¡á¡á¡á¡á¡á¡á¡á¡á¡á¡á¡á¡á¡á¡á¡á¡á¡á¡á¡á¡á¡á¡á¡á¡á¡á¡á¡á¡á¡á¡á¡á¡á¡á¡á¡á¡à¡à¡à¡à¡à¡à¡à¡à¡à¡à¡à¡à¡à¡à¡à¡à¡à¡à¡à¡à¡à¡à¡à¡à¡à¡à¡à¡à¡à¡à¡à
¡à¡à¡à¡à¡à¡à¡à¡à¡à¡à¡à¡à¡à¡à¡à¡à¡à¡à¡à¡à¡à¡à¡à¡à¡à¡à¡à¡à¡á¡á¡á¡á¡á¡á¡á¡á¡á¡á¡á¡á¡á¡á¡á¡á¡á¡á¡á¡á¡á¡á¡á¡á¡á¡á¡á¡á¡á¡á¡á¡á¡á¡á¡á¡á¡á¡á¡á¡á¡á¡à¡à¡à¡à¡à¡à¡à¡à¡à¡à¡à¡à¡à¡à¡à¡à¡à¡à¡à¡à¡à¡à¡à¡à¡à¡à¡à¡à¡à¡à¡à
¡à¡à¡à¡à¡à¡à¡à¡à¡à¡à¡à¡à¡à¡à¡à¡à¡à¡à¡à¡à¡à¡à¡à¡à¡à¡à¡à¡à¡á¡á¡á¡á¡á¡á¡á¡á¡á¡á¡á¡á¡á¡á¡á¡á¡á¡á¡á¡á¡á¡á¡á¡á¡á¡á¡á¡á¡á¡á¡á¡á¡á¡á¡á¡á¡á¡á¡á¡á¡á¡à¡à¡à¡à¡à¡à¡à¡à¡à¡à¡à¡à¡à¡à¡à¡à¡à¡à¡à¡à¡à¡à¡à¡à¡à¡à¡à¡à¡à¡à¡à
¡à¡à¡à¡à¡à¡à¡à¡à¡à¡à¡à¡à¡à¡à¡à¡à¡à¡à¡à¡à¡à¡à¡à¡à¡à¡à¡à¡à¡á¡á¡á¡á¡á¡á¡á¡á¡á¡á¡á¡á¡á¡á¡á¡á¡á¡á¡á¡á¡á¡á¡á¡á¡á¡á¡á¡á¡á¡á¡á¡á¡á¡á¡á¡á¡á¡á¡á¡á¡á¡à¡à¡à¡à¡à¡à¡à¡à¡à¡à¡à¡à¡à¡à¡à¡à¡à¡à¡à¡à¡à¡à¡à¡à¡à¡à¡à¡à¡à¡à¡à
¡à¡à¡à¡à¡à¡à¡à¡à¡à¡à¡à¡à¡à¡à¡à¡à¡à¡à¡à¡à¡à¡à¡à¡à¡à¡à¡à¡à¡á¡á¡á¡á¡á¡á¡á¡á¡á¡á¡á¡á¡á¡á¡á¡á¡á¡á¡á¡á¡á¡á¡á¡á¡á¡á¡á¡á¡á¡á¡á¡á¡á¡á¡á¡á¡á¡á¡á¡á¡á¡à¡à¡à¡à¡à¡à¡à¡à¡à¡à¡à¡à¡à¡à¡à¡à¡à¡à¡à¡à¡à¡à¡à¡à¡à¡à¡à¡à¡à¡à¡à
¡à¡à¡à¡à¡à¡à¡à¡à¡à¡à¡à¡à¡à¡à¡à¡à¡à¡à¡à¡à¡à¡à¡à¡à¡à¡à¡à¡à¡á¡á¡á¡á¡á¡á¡á¡á¡á¡á¡á¡á¡á¡á¡á¡á¡á¡á¡á¡á¡á¡á¡á¡á¡á¡á¡á¡á¡á¡á¡á¡á¡á¡á¡á¡á¡á¡á¡á¡á¡á¡à¡à¡à¡à¡à¡à¡à¡à¡à¡à¡à¡à¡à¡à¡à¡à¡à¡à¡à¡à¡à¡à¡à¡à¡à¡à¡à¡à¡à¡à¡à
¡à¡à¡à¡à¡à¡à¡à¡à¡à¡à¡à¡à¡à¡à¡à¡à¡à¡à¡à¡à¡à¡à¡à¡à¡à¡à¡à¡à¡à¡à¡à¡à¡à¡à¡à¡à¡à¡à¡à¡à¡à¡à¡à¡à¡à¡à¡à¡à¡à¡à¡à¡à¡à¡à¡à¡à¡à¡à¡à¡à¡à¡à¡à¡à¡à¡à¡à¡à¡à¡à¡à¡à¡à¡à¡à¡à¡à¡à¡à¡à¡à¡à¡à¡à¡à¡à¡à¡à¡à¡à¡à¡à¡à¡à¡à¡à¡à¡à¡à¡à
¡à¡à¡à¡à¡à¡à¡à¡à¡à¡à¡à¡à¡à¡à¡à¡à¡à¡à¡à¡à¡à¡à¡à¡à¡à¡à¡à¡à¡à¡à¡à¡à¡à¡à¡à¡à¡à¡à¡à¡à¡à¡à¡à¡à¡à¡à¡à¡à¡à¡à¡à¡à¡à¡à¡à¡à¡à¡à¡à¡à¡à¡à¡à¡à¡à¡à¡à¡à¡à¡à¡à¡à¡à¡à¡à¡à¡à¡à¡à¡à¡à¡à¡à¡à¡à¡à¡à¡à¡à¡à¡à¡à¡à¡à¡à¡à¡à¡à¡à¡à
¡à¡à¡à¡à¡à¡à¡à¡à¡à¡à¡à¡à¡à¡à¡à¡à¡à¡à¡à¡à¡à¡à¡à¡à¡à¡à¡à¡à¡à¡à¡à¡à¡à¡à¡à¡à¡à¡à¡à¡à¡à¡à¡à¡à¡à¡à¡à¡à¡à¡à¡à¡à¡à¡à¡à¡à¡à¡à¡à¡à¡à¡à¡à¡à¡à¡à¡à¡à¡à¡à¡à¡à¡à¡à¡à¡à¡à¡à¡à¡à¡à¡à¡à¡à¡à¡à¡à¡à¡à¡à¡à¡à¡à¡à¡à¡à¡à¡à¡à¡à
¡à¡à¡à¡à¡à¡à¡à¡à¡à¡à¡à¡à¡à¡à¡à¡à¡à¡à¡à¡à¡à¡à¡à¡à¡à¡à¡à¡à¡à¡à¡à¡à¡à¡à¡à¡à¡à¡à¡à¡à¡à¡à¡à¡à¡à¡à¡à¡à¡à¡à¡à¡à¡à¡à¡à¡à¡à¡à¡à¡à¡à¡à¡à¡à¡à¡à¡à¡à¡à¡à¡à¡à¡à¡à¡à¡à¡à¡à¡à¡à¡à¡à¡à¡à¡à¡à¡à¡à¡à¡à¡à¡à¡à¡à¡à¡à¡à¡à¡à¡à
¡à¡à¡à¡à¡à¡à¡à¡à¡à¡à¡à¡à¡à¡à¡à¡à¡à¡à¡à¡à¡à¡à¡à¡à¡à¡à¡à¡à¡à¡à¡à¡à¡à¡à¡à¡à¡à¡à¡à¡à¡à¡à¡à¡à¡à¡à¡à¡à¡à¡à¡à¡à¡à¡à¡à¡à¡à¡à¡à¡à¡à¡à¡à¡à¡à¡à¡à¡à¡à¡à¡à¡à¡à¡à¡à¡à¡à¡à¡à¡à¡à¡à¡à¡à¡à¡à¡à¡à¡à¡à¡à¡à¡à¡à¡à¡à¡à¡à¡à¡à
¡à¡à¡à¡à¡à¡à¡à¡à¡à¡à¡à¡à¡à¡à¡à¡à¡à¡à¡à¡à¡à¡à¡à¡à¡à¡à¡à¡à¡à¡à¡à¡à¡à¡à¡à¡à¡à¡à¡à¡à¡à¡à¡à¡à¡à¡à¡à¡à¡à¡à¡à¡à¡à¡à¡à¡à¡à¡à¡à¡à¡à¡à¡à¡à¡à¡à¡à¡à¡à¡à¡à¡à¡à¡à¡à¡à¡à¡à¡à¡à¡à¡à¡à¡à¡à¡à¡à¡à¡à¡à¡à¡à¡à¡à¡à¡à¡à¡à¡à¡à
¡à¡à¡à¡à¡à¡à¡à¡à¡à¡à¡à¡à¡à¡à¡à¡à¡à¡à¡à¡à¡à¡à¡à¡à¡à¡à¡à¡à¡à¡à¡à¡à¡à¡à¡à¡à¡à¡à¡à¡à¡à¡à¡à¡à¡à¡à¡à¡à¡à¡à¡à¡à¡à¡à¡à¡à¡à¡à¡à¡à¡à¡à¡à¡à¡à¡à¡à¡à¡à¡à¡à¡à¡à¡à¡à¡à¡à¡à¡à¡à¡à¡à¡à¡à¡à¡à¡à¡à¡à¡à¡à¡à¡à¡à¡à¡à¡à¡à¡à¡à
¡à¡à¡à¡à¡à¡à¡à¡à¡à¡à¡à¡à¡à¡à¡à¡à¡à¡à¡à¡à¡à¡à¡à¡à¡à¡à¡à¡à¡à¡à¡à¡à¡à¡à¡à¡à¡à¡à¡à¡à¡à¡à¡à¡à¡à¡à¡à¡à¡à¡à¡à¡à¡à¡à¡à¡à¡à¡à¡à¡à¡à¡à¡à¡à¡à¡à¡à¡à¡à¡à¡à¡à¡à¡à¡à¡à¡à¡à¡à¡à¡à¡à¡à¡à¡à¡à¡à¡à¡à¡à¡à¡à¡à¡à¡à¡à¡à¡à¡à¡à
¡à¡à¡à¡à¡à¡à¡à¡à¡à¡à¡à¡à¡à¡à¡à¡à¡à¡à¡à¡à¡à¡à¡à¡à¡à¡à¡à¡à¡à¡à¡à¡à¡à¡à¡à¡à¡à¡à¡à¡à¡à¡à¡à¡à¡à¡à¡à¡à¡à¡à¡à¡à¡à¡à¡à¡à¡à¡à¡à¡à¡à¡à¡à¡à¡à¡à¡à¡à¡à¡à¡à¡à¡à¡à¡à¡à¡à¡à¡à¡à¡à¡à¡à¡à¡à¡à¡à¡à¡à¡à¡à¡à¡à¡à¡à¡à¡à¡à¡à¡à
¡à¡à¡à¡à¡à¡à¡à¡à¡à¡à¡à¡à¡à¡à¡à¡à¡à¡à¡à¡à¡à¡à¡à¡à¡à¡à¡à¡à¡à¡à¡à¡à¡à¡à¡à¡à¡à¡à¡à¡à¡à¡à¡à¡à¡à¡à¡à¡à¡à¡à¡à¡à¡à¡à¡à¡à¡à¡à¡à¡à¡à¡à¡à¡à¡à¡à¡à¡à¡à¡à¡à¡à¡à¡à¡à¡à¡à¡à¡à¡à¡à¡à¡à¡à¡à¡à¡à¡à¡à¡à¡à¡à¡à¡à¡à¡à¡à¡à¡à¡à
¡à¡à¡à¡à¡à¡à¡à¡à¡à¡à¡à¡à¡à¡à¡à¡à¡à¡à¡à¡à¡à¡à¡à¡à¡à¡à¡à¡à¡à¡à¡à¡à¡à¡à¡à¡à¡à¡à¡à¡à¡à¡à¡à¡à¡à¡à¡à¡à¡à¡à¡à¡à¡à¡à¡à¡à¡à¡à¡à¡à¡à¡à¡à¡à¡à¡à¡à¡à¡à¡à¡à¡à¡à¡à¡à¡à¡à¡à¡à¡à¡à¡à¡à¡à¡à¡à¡à¡à¡à¡à¡à¡à¡à¡à¡à¡à¡à¡à¡à¡à
¡à¡à¡à¡à¡à¡à¡à¡à¡à¡à¡à¡à¡à¡à¡à¡à¡à¡à¡à¡à¡à¡à¡à¡à¡à¡à¡à¡à¡à¡à¡à¡à¡à¡à¡à¡à¡à¡à¡à¡à¡à¡à¡à¡à¡à¡à¡à¡à¡à¡à¡à¡à¡à¡à¡à¡à¡à¡à¡à¡à¡à¡à¡à¡à¡à¡à¡à¡à¡à¡à¡à¡à¡à¡à¡à¡à¡à¡à¡à¡à¡à¡à¡à¡à¡à¡à¡à¡à¡à¡à¡à¡à¡à¡à¡à¡à¡à¡à¡à¡à
¡à¡à¡à¡à¡à¡à¡à¡à¡à¡à¡à¡à¡à¡à¡à¡à¡à¡à¡à¡à¡à¡à¡à¡à¡à¡à¡à¡à¡à¡à¡à¡à¡à¡à¡à¡à¡à¡à¡à¡à¡à¡à¡à¡à¡à¡à¡à¡à¡à¡à¡à¡à¡à¡à¡à¡à¡à¡à¡à¡à¡à¡à¡à¡à¡à¡à¡à¡à¡à¡à¡à¡à¡à¡à¡à¡à¡à¡à¡à¡à¡à¡à¡à¡à¡à¡à¡à¡à¡à¡à¡à¡à¡à¡à¡à¡à¡à¡à¡à¡à
¡à¡à¡à¡à¡à¡à¡à¡à¡à¡à¡à¡à¡à¡à¡à¡à¡à¡à¡à¡à¡à¡à¡à¡à¡à¡à¡à¡à¡à¡à¡à¡à¡à¡à¡à¡à¡à¡à¡à¡à¡à¡à¡à¡à¡à¡à¡à¡à¡à¡à¡à¡à¡à¡à¡à¡à¡à¡à¡à¡à¡à¡à¡à¡à¡à¡à¡à¡à¡à¡à¡à¡à¡à¡à¡à¡à¡à¡à¡à¡à¡à¡à¡à¡à¡à¡à¡à¡à¡à¡à¡à¡à¡à¡à¡à¡à¡à¡à¡à¡à
¡à¡à¡à¡à¡à¡à¡à¡à¡à¡à¡à¡à¡à¡à¡à¡à¡à¡à¡à¡à¡à¡à¡à¡à¡à¡à¡à¡à¡à¡à¡à¡à¡à¡à¡à¡à¡à¡à¡à¡à¡à¡à¡à¡à¡à¡à¡à¡à¡à¡à¡à¡à¡à¡à¡à¡à¡à¡à¡à¡à¡à¡à¡à¡à¡à¡à¡à¡à¡à¡à¡à¡à¡à¡à¡à¡à¡à¡à¡à¡à¡à¡à¡à¡à¡à¡à¡à¡à¡à¡à¡à¡à¡à¡à¡à¡à¡à¡à¡à¡à
¡à¡à¡à¡à¡à¡à¡à¡à¡à¡à¡à¡à¡à¡à¡à¡à¡à¡à¡à¡à¡à¡à¡à¡à¡à¡à¡à¡à¡à¡à¡à¡à¡à¡à¡à¡à¡à¡à¡à¡à¡à¡à¡à¡à¡à¡à¡à¡à¡à¡à¡à¡à¡à¡à¡à¡à¡à¡à¡à¡à¡à¡à¡à¡à¡à¡à¡à¡à¡à¡à¡à¡à¡à¡à¡à¡à¡à¡à¡à¡à¡à¡à¡à¡à¡à¡à¡à¡à¡à¡à¡à¡à¡à¡à¡à¡à¡à¡à¡à¡à
¡à¡à¡à¡à¡à¡à¡à¡à¡à¡à¡à¡à¡à¡à¡à¡à¡à¡à¡à¡à¡à¡à¡à¡à¡à¡à¡à¡à¡à¡à¡à¡à¡à¡à¡à¡à¡à¡à¡à¡à¡à¡à¡à¡à¡à¡à¡à¡à¡à¡à¡à¡à¡à¡à¡à¡à¡à¡à¡à¡à¡à¡à¡à¡à¡à¡à¡à¡à¡à¡à¡à¡à¡à¡à¡à¡à¡à¡à¡à¡à¡à¡à¡à¡à¡à¡à¡à¡à¡à¡à¡à¡à¡à¡à¡à¡à¡à¡à¡à¡à
¡à¡à¡à¡à¡à¡à¡à¡à¡à¡à¡à¡à¡à¡à¡à¡à¡à¡à¡à¡à¡à¡à¡à¡à¡à¡à¡à¡à¡à¡à¡à¡à¡à¡à¡à¡à¡à¡à¡à¡à¡à¡à¡à¡à¡à¡à¡à¡à¡à¡à¡à¡à¡à¡à¡à¡à¡à¡à¡à¡à¡à¡à¡à¡à¡à¡à¡à¡à¡à¡à¡à¡à¡à¡à¡à¡à¡à¡à¡à¡à¡à¡à¡à¡à¡à¡à¡à¡à¡à¡à¡à¡à¡à¡à¡à¡à¡à¡à¡à¡à
¡à¡à¡à¡à¡à¡à¡à¡à¡à¡à¡à¡à¡à¡à¡à¡à¡à¡à¡à¡à¡à¡à¡à¡à¡à¡à¡à¡à¡à¡à¡à¡à¡à¡à¡à¡à¡à¡à¡à¡à¡à¡à¡à¡à¡à¡à¡à¡à¡à¡à¡à¡à¡à¡à¡à¡à¡à¡à¡à¡à¡à¡à¡à¡à¡à¡à¡à¡à¡à¡à¡à¡à¡à¡à¡à¡à¡à¡à¡à¡à¡à¡à¡à¡à¡à¡à¡à¡à¡à¡à¡à¡à¡à¡à¡à¡à¡à¡à¡à¡à
¡à¡à¡à¡à¡à¡à¡à¡à¡à¡à¡à¡à¡à¡à¡à¡à¡à¡à¡à¡à¡à¡à¡à¡à¡à¡à¡à¡à¡à¡à¡à¡à¡à¡à¡à¡à¡à¡à¡à¡à¡à¡à¡à¡à¡à¡à¡à¡à¡à¡à¡à¡à¡à¡à¡à¡à¡à¡à¡à¡à¡à¡à¡à¡à¡à¡à¡à¡à¡à¡à¡à¡à¡à¡à¡à¡à¡à¡à¡à¡à¡à¡à¡à¡à¡à¡à¡à¡à¡à¡à¡à¡à¡à¡à¡à¡à¡à¡à¡à¡à
¡à¡à¡à¡à¡à¡à¡à¡à¡à¡à¡à¡à¡à¡à¡à¡à¡à¡à¡à¡á¡á¡á¡á¡à¡à¡à¡à¡à¡à¡à¡à¡à¡à¡à¡à¡à¡à¡à¡à¡à¡à¡à¡à¡à¡à¡à¡à¡à¡à¡à¡à¡à¡à¡à¡à¡à¡à¡à¡à¡à¡à¡à¡à¡à¡à¡à¡à¡à¡à¡á¡á¡á¡á¡á¡á¡á¡á¡á¡á¡á¡á¡á¡à¡à¡à¡à¡à¡à¡à¡à¡à¡à¡à¡à¡à¡à¡à¡à¡à¡à
¡à¡à¡à¡à¡à¡à¡à¡à¡à¡à¡à¡à¡à¡à¡à¡à¡à¡à¡à¡á¡á¡á¡á¡à¡à¡à¡à¡à¡à¡à¡à¡à¡à¡à¡à¡à¡à¡à¡à¡à¡à¡à¡à¡à¡à¡à¡à¡à¡à¡à¡à¡à¡à¡à¡à¡à¡à¡à¡à¡à¡à¡à¡à¡à¡à¡à¡à¡à¡à¡á¡á¡á¡á¡á¡á¡á¡á¡á¡á¡á¡á¡á¡à¡à¡à¡à¡à¡à¡à¡à¡à¡à¡à¡à¡à¡à¡à¡à¡à¡à
¡à¡à¡à¡à¡à¡à¡à¡à¡à¡à¡à¡à¡à¡à¡à¡à¡à¡à¡à¡á¡á¡á¡á¡à¡à¡à¡à¡à¡à¡à¡à¡à¡à¡à¡à¡à¡à¡à¡à¡à¡à¡à¡à¡à¡à¡à¡à¡à¡à¡à¡à¡à¡à¡à¡à¡à¡à¡à¡à¡à¡à¡à¡à¡à¡à¡à¡à¡à¡à¡á¡á¡á¡á¡á¡á¡á¡á¡á¡á¡á¡á¡á¡à¡à¡à¡à¡à¡à¡à¡à¡à¡à¡à¡à¡à¡à¡à¡à¡à¡à
¡à¡à¡à¡à¡à¡à¡à¡à¡à¡à¡à¡à¡à¡à¡à¡à¡à¡à¡à¡á¡á¡á¡á¡à¡à¡à¡à¡à¡à¡à¡à¡à¡à¡à¡à¡à¡à¡à¡à¡à¡à¡à¡à¡à¡à¡à¡à¡à¡à¡à¡à¡à¡à¡à¡à¡à¡à¡à¡à¡à¡à¡à¡à¡à¡à¡à¡à¡à¡à¡á¡á¡á¡á¡á¡á¡á¡á¡á¡á¡á¡á¡á¡à¡à¡à¡à¡à¡à¡à¡à¡à¡à¡à¡à¡à¡à¡à¡à¡à¡à
¡à¡à¡à¡à¡à¡à¡à¡à¡à¡à¡à¡à¡à¡à¡à¡à¡à¡à¡à¡á¡á¡á¡á¡à¡à¡à¡à¡à¡à¡à¡à¡à¡à¡à¡à¡à¡à¡à¡à¡à¡à¡à¡à¡à¡à¡à¡à¡à¡à¡à¡à¡à¡à¡à¡à¡à¡à¡à¡à¡à¡à¡à¡à¡à¡à¡à¡à¡à¡à¡á¡á¡á¡á¡á¡á¡á¡á¡á¡á¡á¡á¡á¡à¡à¡à¡à¡à¡à¡à¡à¡à¡à¡à¡à¡à¡à¡à¡à¡à¡à
¡à¡à¡à¡à¡à¡à¡à¡à¡à¡à¡à¡à¡à¡à¡à¡à¡à¡à¡à¡á¡á¡á¡á¡à¡à¡à¡à¡à¡à¡à¡à¡à¡à¡à¡à¡à¡à¡à¡à¡à¡à¡à¡à¡à¡à¡à¡à¡à¡à¡à¡à¡à¡à¡à¡à¡à¡à¡à¡à¡à¡à¡à¡à¡à¡à¡à¡à¡à¡à¡á¡á¡á¡á¡á¡á¡á¡á¡á¡á¡á¡á¡á¡à¡à¡à¡à¡à¡à¡à¡à¡à¡à¡à¡à¡à¡à¡à¡à¡à¡à
¡à¡à¡à¡à¡à¡à¡à¡à¡à¡à¡à¡à¡à¡à¡à¡à¡à¡à¡à¡à¡à¡à¡à¡à¡à¡à¡à¡à¡à¡à¡à¡à¡à¡à¡à¡à¡à¡à¡à¡à¡à¡à¡à¡à¡à¡à¡à¡à¡à¡à¡à¡à¡à¡à¡à¡à¡à¡à¡à¡à¡à¡à¡à¡à¡à¡à¡à¡à¡à¡á¡á¡á¡á¡á¡á¡á¡á¡á¡á¡á¡á¡á¡à¡à¡à¡à¡à¡à¡à¡à¡à¡à¡à¡à¡à¡à¡à¡à¡à¡à
¡à¡à¡à¡à¡à¡à¡à¡à¡à¡à¡à¡à¡à¡à¡à¡à¡à¡à¡à¡à¡à¡à¡à¡à¡à¡à¡à¡à¡à¡à¡à¡à¡à¡à¡à¡à¡à¡à¡à¡à¡à¡à¡à¡à¡à¡à¡à¡à¡à¡à¡à¡à¡à¡à¡à¡à¡à¡à¡à¡à¡à¡à¡à¡à¡à¡à¡à¡à¡à¡á¡á¡á¡á¡á¡á¡á¡á¡á¡á¡á¡á¡á¡à¡à¡à¡à¡à¡à¡à¡à¡à¡à¡à¡à¡à¡à¡à¡à¡à¡à
¡à¡à¡à¡à¡à¡à¡à¡à¡à¡à¡à¡à¡à¡à¡à¡à¡à¡à¡à¡à¡à¡à¡à¡à¡à¡à¡à¡à¡à¡à¡à¡à¡à¡à¡à¡à¡à¡à¡à¡à¡à¡à¡à¡à¡à¡à¡à¡à¡à¡à¡à¡à¡à¡à¡à¡à¡à¡à¡à¡à¡à¡à¡à¡à¡à¡à¡à¡à¡à¡á¡á¡á¡á¡á¡á¡á¡á¡á¡á¡á¡á¡á¡à¡à¡à¡à¡à¡à¡à¡à¡à¡à¡à¡à¡à¡à¡à¡à¡à¡à
¡à¡à¡à¡à¡à¡à¡à¡à¡à¡à¡à¡à¡à¡à¡à¡à¡à¡à¡à¡à¡à¡à¡à¡à¡à¡à¡à¡à¡à¡à¡à¡à¡à¡à¡à¡à¡à¡à¡à¡à¡à¡à¡à¡à¡à¡à¡à¡à¡à¡à¡à¡à¡à¡à¡à¡à¡à¡à¡à¡à¡à¡à¡à¡à¡à¡à¡à¡à¡à¡á¡á¡á¡á¡á¡á¡á¡á¡á¡á¡á¡á¡á¡à¡à¡à¡à¡à¡à¡à¡à¡à¡à¡à¡à¡à¡à¡à¡à¡à¡à
¡à¡à¡à¡à¡à¡à¡à¡à¡à¡à¡à¡à¡à¡à¡à¡à¡à¡à¡à¡à¡à¡à¡à¡à¡à¡à¡à¡à¡à¡à¡à¡à¡à¡à¡à¡à¡à¡à¡à¡à¡à¡à¡à¡à¡à¡à¡à¡à¡à¡à¡à¡à¡à¡à¡à¡à¡à¡à¡à¡à¡à¡à¡à¡à¡à¡à¡à¡à¡à¡á¡á¡á¡á¡á¡á¡á¡á¡á¡á¡á¡á¡á¡à¡à¡à¡à¡à¡à¡à¡à¡à¡à¡à¡à¡à¡à¡à¡à¡à¡à
¡à¡à¡à¡à¡à¡à¡à¡à¡à¡à¡à¡à¡à¡à¡à¡à¡à¡à¡à¡à¡à¡à¡à¡à¡à¡à¡à¡à¡à¡à¡à¡à¡à¡à¡à¡à¡à¡à¡à¡à¡à¡à¡à¡à¡à¡à¡à¡à¡à¡à¡à¡à¡à¡à¡à¡à¡à¡à¡à¡à¡à¡à¡à¡à¡à¡à¡à¡à¡à¡á¡á¡á¡á¡á¡á¡á¡á¡á¡á¡á¡á¡á¡à¡à¡à¡à¡à¡à¡à¡à¡à¡à¡à¡à¡à¡à¡à¡à¡à¡à
¡à¡à¡à¡à¡à¡à¡à¡à¡à¡à¡à¡à¡à¡à¡à¡à¡à¡à¡à¡à¡à¡à¡à¡à¡à¡à¡à¡à¡à¡à¡à¡à¡à¡à¡à¡à¡à¡à¡à¡à¡à¡à¡à¡à¡à¡à¡à¡à¡à¡à¡à¡à¡à¡à¡à¡à¡à¡à¡à¡à¡à¡à¡à¡à¡à¡à¡à¡à¡à¡á¡á¡á¡á¡á¡á¡á¡á¡á¡á¡á¡á¡á¡à¡à¡à¡à¡à¡à¡à¡à¡à¡à¡à¡à¡à¡à¡à¡à¡à¡à
¡à¡à¡à¡à¡à¡à¡à¡à¡à¡à¡à¡à¡à¡à¡à¡à¡à¡à¡à¡à¡à¡à¡à¡à¡à¡à¡à¡à¡à¡à¡à¡à¡à¡à¡à¡à¡à¡à¡à¡à¡à¡à¡à¡à¡à¡à¡à¡à¡à¡à¡à¡à¡à¡à¡à¡à¡à¡à¡à¡à¡à¡à¡à¡à¡à¡à¡à¡à¡à¡á¡á¡á¡á¡á¡á¡á¡á¡á¡á¡á¡á¡á¡à¡à¡à¡à¡à¡à¡à¡à¡à¡à¡à¡à¡à¡à¡à¡à¡à¡à
¡à¡à¡à¡à¡à¡à¡à¡à¡à¡à¡à¡à¡à¡à¡à¡à¡à¡à¡à¡à¡à¡à¡à¡à¡à¡à¡à¡à¡à¡à¡à¡à¡à¡à¡à¡à¡à¡à¡à¡à¡à¡à¡à¡à¡à¡à¡à¡à¡à¡à¡à¡à¡à¡à¡à¡à¡à¡à¡à¡à¡à¡à¡à¡à¡à¡à¡à¡à¡à¡à¡à¡à¡à¡à¡à¡à¡à¡à¡à¡à¡à¡à¡à¡à¡à¡à¡à¡à¡à¡à¡à¡à¡à¡à¡à¡à¡à¡à¡à¡à
¡à¡à¡à¡à¡à¡à¡à¡à¡à¡à¡à¡à¡à¡à¡à¡à¡à¡à¡à¡à¡à¡à¡à¡à¡à¡à¡à¡à¡à¡à¡à¡à¡à¡à¡à¡à¡à¡à¡à¡à¡à¡à¡à¡à¡à¡à¡à¡à¡à¡à¡à¡à¡à¡à¡à¡à¡à¡à¡à¡à¡à¡à¡à¡à¡à¡à¡à¡à¡à¡à¡à¡à¡à¡à¡à¡à¡à¡à¡à¡à¡à¡à¡à¡à¡à¡à¡à¡à¡à¡à¡à¡à¡à¡à¡à¡à¡à¡à¡à¡à
¡à¡à¡à¡à¡à¡à¡à¡à¡à¡à¡à¡à¡à¡à¡à¡à¡à¡à¡à¡à¡à¡à¡à¡à¡à¡à¡à¡à¡à¡à¡à¡à¡à¡à¡à¡à¡à¡à¡à¡à¡à¡à¡à¡à¡à¡à¡à¡à¡à¡à¡à¡à¡à¡à¡à¡à¡à¡à¡à¡à¡à¡à¡à¡à¡à¡à¡à¡à¡à¡à¡à¡à¡à¡à¡à¡à¡à¡à¡à¡à¡à¡à¡à¡à¡à¡à¡à¡à¡à¡à¡à¡à¡à¡à¡à¡à¡à¡à¡à¡à
¡à¡à¡à¡à¡à¡à¡à¡à¡à¡à¡à¡à¡à¡à¡à¡à¡à¡à¡à¡à¡à¡à¡à¡à¡à¡à¡à¡à¡à¡à¡à¡à¡à¡à¡à¡à¡à¡à¡à¡à¡à¡à¡à¡à¡à¡à¡à¡à¡à¡à¡à¡à¡à¡à¡à¡à¡à¡à¡à¡à¡à¡à¡à¡à¡à¡à¡à¡à¡à¡à¡à¡à¡à¡à¡à¡à¡à¡à¡à¡à¡à¡à¡à¡à¡à¡à¡à¡à¡à¡à¡à¡à¡à¡à¡à¡à¡à¡à¡à¡à
¡à¡à¡à¡à¡à¡à¡à¡à¡à¡à¡à¡à¡à¡à¡à¡à¡à¡à¡à¡à¡à¡à¡à¡à¡à¡à¡à¡à¡à¡à¡à¡à¡à¡à¡à¡à¡à¡à¡à¡à¡à¡à¡à¡à¡à¡à¡à¡à¡à¡à¡à¡à¡à¡à¡à¡à¡à¡à¡à¡à¡à¡à¡à¡à¡à¡à¡à¡à¡à¡à¡à¡à¡à¡à¡à¡à¡à¡à¡à¡à¡à¡à¡à¡à¡à¡à¡à¡à¡à¡à¡à¡à¡à¡à¡à¡à¡à¡à¡à¡à
¡à¡à¡à¡à¡à¡à¡à¡à¡à¡à¡à¡à¡à¡à¡à¡à¡à¡à¡à¡à¡à¡à¡à¡à¡à¡à¡à¡à¡à¡à¡à¡à¡à¡à¡à¡à¡à¡à¡à¡à¡à¡à¡à¡à¡à¡à¡à¡à¡à¡à¡à¡à¡à¡à¡à¡à¡à¡à¡à¡à¡à¡à¡à¡à¡à¡à¡à¡à¡à¡à¡à¡à¡à¡à¡à¡à¡à¡à¡à¡à¡à¡à¡à¡à¡à¡à¡à¡à¡à¡à¡à¡à¡à¡à¡à¡à¡à¡à¡à¡à
¡à¡à¡à¡à¡à¡à¡à¡à¡à¡à¡à¡à¡à¡à¡à¡à¡à¡à¡à¡à¡à¡à¡à¡à¡à¡à¡à¡à¡à¡à¡à¡à¡à¡à¡à¡à¡à¡à¡à¡à¡à¡à¡à¡à¡à¡à¡à¡à¡à¡à¡à¡à¡à¡à¡à¡à¡à¡à¡à¡à¡à¡à¡à¡à¡à¡à¡à¡à¡à¡à¡à¡à¡à¡à¡à¡à¡à¡à¡à¡à¡à¡à¡à¡à¡à¡à¡à¡à¡à¡à¡à¡à¡à¡à¡à¡à¡à¡à¡à¡à
¡à¡à¡à¡à¡à¡à¡à¡à¡à¡à¡à¡à¡à¡à¡à¡à¡à¡à¡à¡à¡à¡à¡à¡à¡à¡à¡à¡à¡à¡à¡à¡à¡à¡à¡à¡à¡à¡à¡à¡à¡à¡à¡à¡à¡à¡à¡à¡à¡à¡à¡à¡à¡à¡à¡à¡à¡à¡à¡à¡à¡à¡à¡à¡à¡à¡à¡à¡à¡à¡à¡à¡à¡à¡à¡à¡à¡à¡à¡à¡à¡à¡à¡à¡à¡à¡à¡à¡à¡à¡à¡à¡à¡à¡à¡à¡à¡à¡à¡à¡à
¡à¡à¡à¡à¡à¡à¡à¡à¡à¡à¡à¡à¡à¡à¡à¡à¡à¡à¡à¡à¡à¡à¡à¡à¡à¡à¡à¡à¡à¡à¡à¡à¡à¡à¡à¡à¡à¡à¡à¡à¡à¡à¡à¡à¡à¡à¡à¡à¡à¡à¡à¡à¡à¡à¡à¡à¡à¡à¡à¡à¡à¡à¡à¡à¡à¡à¡à¡à¡à¡à¡à¡à¡à¡à¡à¡à¡à¡à¡à¡à¡à¡à¡à¡à¡à¡à¡à¡à¡à¡à¡à¡à¡à¡à¡à¡à¡à¡à¡à¡à
¡à¡à¡à¡à¡à¡à¡à¡à¡à¡à¡à¡à¡à¡à¡à¡à¡à¡à¡à¡à¡à¡à¡à¡à¡à¡à¡à¡à¡à¡à¡à¡à¡à¡à¡à¡à¡à¡à¡à¡à¡à¡à¡à¡à¡à¡à¡à¡à¡à¡à¡à¡à¡à¡à¡à¡à¡à¡à¡à¡à¡à¡à¡à¡à¡à¡à¡à¡à¡à¡à¡à¡à¡à¡à¡à¡à¡à¡à¡à¡à¡à¡à¡à¡à¡à¡à¡à¡à¡à¡à¡à¡à¡à¡à¡à¡à¡à¡à¡à¡à
¡à¡à¡à¡à¡à¡à¡à¡à¡à¡à¡à¡à¡à¡à¡à¡à¡à¡à¡à¡à¡à¡à¡à¡à¡à¡à¡à¡à¡à¡à¡à¡à¡à¡à¡à¡à¡à¡à¡à¡à¡à¡à¡à¡à¡à¡à¡à¡à¡à¡à¡à¡à¡à¡à¡à¡à¡à¡à¡à¡à¡à¡à¡à¡à¡à¡à¡à¡à¡à¡à¡à¡à¡à¡à¡à¡à¡à¡à¡à¡à¡à¡à¡à¡à¡à¡à¡à¡à¡à¡à¡à¡à¡à¡à¡à¡à¡à¡à¡à¡à
¡à¡à¡à¡à¡à¡à¡à¡à¡à¡à¡à¡à¡à¡à¡à¡à¡à¡à¡à¡à¡à¡à¡à¡à¡à¡à¡à¡à¡à¡à¡à¡à¡à¡à¡à¡à¡à¡à¡à¡à¡à¡à¡à¡à¡à¡à¡à¡à¡à¡à¡à¡à¡à¡à¡à¡à¡à¡à¡à¡à¡à¡à¡à¡à¡à¡à¡à¡à¡à¡à¡à¡à¡à¡à¡à¡à¡à¡à¡à¡à¡à¡à¡à¡à¡à¡à¡à¡à¡à¡à¡à¡à¡à¡à¡à¡à¡à¡à¡à¡à
¡à¡à¡à¡à¡à¡à¡à¡à¡à¡à¡à¡à¡à¡à¡à¡à¡à¡à¡à¡à¡à¡à¡à¡à¡à¡à¡à¡à¡à¡à¡à¡à¡à¡à¡à¡à¡à¡à¡à¡à¡à¡à¡à¡à¡à¡à¡à¡à¡à¡à¡à¡à¡à¡à¡à¡à¡à¡à¡à¡à¡à¡à¡à¡à¡à¡à¡à¡à¡à¡à¡à¡à¡à¡à¡à¡à¡à¡à¡à¡à¡à¡à¡à¡à¡à¡à¡à¡à¡à¡à¡à¡à¡à¡à¡à¡à¡à¡à¡à¡à
¡à¡à¡à¡à¡à¡à¡à¡à¡à¡à¡à¡à¡à¡à¡à¡à¡à¡à¡à¡à¡à¡à¡à¡à¡à¡à¡à¡à¡à¡à¡à¡à¡à¡à¡à¡à¡à¡à¡à¡à¡à¡à¡à¡à¡à¡à¡à¡à¡à¡à¡à¡à¡à¡à¡à¡à¡à¡à¡à¡à¡à¡à¡à¡à¡à¡à¡à¡à¡à¡à¡à¡à¡à¡à¡à¡à¡à¡à¡à¡à¡à¡à¡à¡à¡à¡à¡à¡à¡à¡à¡à¡à¡à¡à¡à¡à¡à¡à¡à¡à
¡à¡à¡à¡à¡à¡à¡à¡à¡à¡à¡à¡à¡à¡à¡à¡à¡à¡à¡à¡à¡à¡à¡à¡à¡à¡à¡à¡à¡à¡à¡à¡à¡à¡à¡à¡à¡à¡à¡à¡à¡à¡à¡à¡à¡à¡à¡à¡à¡à¡à¡à¡à¡à¡à¡à¡à¡à¡à¡à¡à¡à¡à¡à¡à¡à¡à¡à¡à¡à¡à¡à¡à¡à¡à¡à¡à¡à¡à¡à¡à¡à¡à¡à¡à¡à¡à¡à¡à¡à¡à¡à¡à¡à¡à¡à¡à¡à¡à¡à¡à
¡à¡à¡à¡à¡à¡à¡à¡à¡à¡à¡à¡à¡à¡à¡à¡à¡à¡à¡à¡à¡à¡à¡à¡à¡à¡à¡à¡à¡à¡à¡à¡à¡à¡à¡à¡à¡à¡à¡à¡à¡à¡à¡à¡à¡à¡à¡à¡à¡à¡à¡à¡à¡à¡à¡à¡à¡à¡à¡à¡à¡à¡à¡à¡à¡à¡à¡à¡à¡à¡à¡à¡à¡à¡à¡à¡à¡à¡à¡à¡à¡à¡à¡à¡à¡à¡à¡à¡à¡à¡à¡à¡à¡à¡à¡à¡à¡à¡à¡à¡à
¡à¡à¡à¡à¡à¡à¡à¡à¡à¡à¡à¡à¡à¡à¡à¡à¡à¡à¡à¡à¡à¡à¡à¡à¡à¡à¡à¡à¡à¡à¡à¡à¡à¡à¡à¡à¡à¡à¡à¡à¡à¡à¡à¡à¡à¡à¡à¡à¡à¡à¡à¡à¡à¡à¡à¡à¡à¡à¡à¡à¡à¡à¡à¡à¡à¡à¡à¡à¡à¡à¡à¡à¡à¡à¡à¡à¡à¡à¡à¡à¡à¡à¡à¡à¡à¡à¡à¡à¡à¡à¡à¡à¡à¡à¡à¡à¡à¡à¡à¡à
¡à¡à¡à¡à¡à¡à¡à¡à¡à¡à¡à¡à¡à¡à¡à¡à¡à¡à¡à¡à¡à¡à¡à¡à¡à¡à¡à¡à¡à¡à¡à¡à¡à¡à¡à¡à¡à¡à¡à¡à¡à¡à¡à¡à¡à¡à¡à¡à¡à¡à¡à¡à¡à¡à¡à¡à¡à¡à¡à¡à¡à¡à¡à¡à¡à¡à¡à¡à¡à¡à¡à¡à¡à¡à¡à¡à¡à¡à¡à¡à¡à¡à¡à¡à¡à¡à¡à¡à¡à¡à¡à¡à¡à¡à¡à¡à¡à¡à¡à¡à
¡à¡à¡à¡à¡à¡à¡à¡à¡à¡à¡à¡à¡à¡à¡à¡à¡à¡à¡à¡à¡à¡à¡à¡à¡à¡à¡à¡à¡à¡à¡à¡à¡à¡à¡à¡à¡à¡à¡à¡à¡à¡à¡à¡à¡à¡à¡à¡à¡à¡à¡à¡à¡à¡à¡à¡à¡à¡à¡à¡à¡à¡à¡à¡à¡à¡à¡à¡à¡à¡à¡à¡à¡à¡à¡à¡à¡à¡à¡à¡à¡à¡à¡à¡à¡à¡à¡à¡à¡à¡à¡à¡à¡à¡à¡à¡à¡à¡à¡à¡à
¡à¡à¡à¡à¡à¡à¡à¡à¡à¡à¡à¡à¡à¡à¡à¡à¡à¡à¡à¡à¡à¡à¡à¡à¡à¡à¡à¡à¡à¡à¡à¡à¡à¡à¡à¡à¡à¡à¡à¡à¡à¡à¡à¡à¡à¡à¡à¡à¡à¡à¡à¡à¡à¡à¡à¡à¡à¡à¡à¡à¡à¡à¡à¡à¡à¡à¡à¡à¡à¡à¡à¡à¡à¡à¡à¡à¡à¡à¡à¡à¡à¡à¡à¡à¡à¡à¡à¡à¡à¡à¡à¡à¡à¡à¡à¡à¡à¡à¡à¡à
¡à¡à¡à¡à¡à¡à¡à¡à¡à¡à¡à¡à¡à¡à¡à¡à¡à¡à¡à¡à¡à¡à¡à¡à¡à¡à¡à¡à¡à¡à¡à¡à¡à¡à¡à¡à¡à¡à¡à¡à¡à¡à¡à¡à¡à¡à¡à¡à¡à¡à¡à¡à¡à¡à¡à¡à¡à¡à¡à¡à¡à¡à¡à¡à¡à¡à¡à¡à¡à¡à¡à¡à¡à¡à¡à¡à¡à¡à¡à¡à¡à¡à¡à¡à¡à¡à¡à¡à¡à¡à¡à¡à¡à¡à¡à¡à¡à¡à¡à¡à
¡à¡à¡à¡à¡à¡à¡à¡à¡à¡à¡à¡à¡à¡à¡à¡à¡à¡à¡à¡à¡à¡à¡à¡à¡à¡à¡à¡à¡à¡à¡à¡à¡à¡à¡à¡à¡à¡à¡à¡à¡à¡à¡à¡à¡à¡à¡à¡à¡à¡à¡à¡à¡à¡à¡à¡à¡à¡à¡à¡à¡à¡à¡à¡à¡à¡à¡à¡à¡à¡à¡à¡à¡à¡à¡à¡à¡à¡à¡à¡à¡à¡à¡à¡à¡à¡à¡à¡à¡à¡à¡à¡à¡à¡à¡à¡à¡à¡à¡à¡à
¡à¡à¡à¡à¡à¡à¡à¡à¡à¡à¡à¡à¡à¡à¡à¡à¡à¡à¡à¡à¡à¡à¡à¡à¡à¡à¡à¡à¡à¡à¡à¡à¡à¡à¡à¡à¡à¡à¡à¡à¡à¡à¡à¡à¡à¡à¡à¡à¡à¡à¡à¡à¡à¡à¡à¡à¡à¡à¡à¡à¡à¡à¡à¡à¡à¡à¡à¡à¡à¡à¡à¡à¡à¡à¡à¡à¡à¡à¡à¡à¡à¡à¡à¡à¡à¡à¡à¡à¡à¡à¡à¡à¡à¡à¡à¡à¡à¡à¡à¡à
¡à¡à¡à¡à¡à¡à¡à¡à¡à¡à¡à¡à¡à¡à¡à¡à¡à¡à¡à¡à¡à¡à¡à¡à¡à¡à¡à¡à¡à¡à¡à¡à¡à¡à¡à¡à¡à¡à¡à¡à¡à¡à¡à¡à¡à¡à¡à¡à¡à¡à¡à¡à¡à¡à¡à¡à¡à¡à¡à¡à¡à¡à¡à¡à¡à¡à¡à¡à¡à¡à¡à¡à¡à¡à¡à¡à¡à¡à¡à¡à¡à¡à¡à¡à¡à¡à¡à¡à¡à¡à¡à¡à¡à¡à¡à¡à¡à¡à¡à¡à
¡à¡à¡à¡à¡à¡à¡à¡à¡à¡à¡à¡à¡à¡à¡à¡à¡à¡à¡à¡à¡à¡à¡à¡à¡à¡à¡à¡à¡à¡à¡à¡à¡à¡à¡à¡à¡à¡à¡à¡à¡à¡à¡à¡à¡à¡à¡à¡à¡à¡à¡à¡à¡à¡à¡à¡à¡à¡à¡à¡à¡à¡à¡à¡à¡à¡à¡à¡à¡à¡à¡à¡à¡à¡à¡à¡à¡à¡à¡à¡à¡à¡à¡à¡à¡à¡à¡à¡à¡à¡à¡à¡à¡à¡à¡à¡à¡à¡à¡à¡à
¡à¡à¡à¡à¡à¡à¡à¡à¡à¡à¡à¡à¡à¡à¡à¡à¡à¡à¡à¡à¡à¡à¡à¡à¡à¡à¡à¡à¡à¡à¡à¡à¡à¡à¡à¡à¡à¡à¡à¡à¡à¡à¡à¡à¡à¡à¡à¡à¡à¡à¡à¡à¡à¡à¡à¡à¡à¡à¡à¡à¡à¡à¡à¡à¡à¡à¡à¡à¡à¡à¡à¡à¡à¡à¡à¡à¡à¡à¡à¡à¡à¡à¡à¡à¡à¡à¡à¡à¡à¡à¡à¡à¡à¡à¡à¡à¡à¡à¡à¡à
¡à¡à¡à¡à¡à¡à¡à¡à¡à¡à¡à¡à¡à¡à¡à¡à¡à¡à¡à¡à¡à¡à¡à¡à¡à¡à¡à¡à¡à¡à¡à¡à¡à¡à¡à¡à¡à¡à¡à¡à¡à¡à¡à¡à¡à¡à¡à¡à¡à¡à¡à¡à¡à¡à¡à¡à¡à¡à¡à¡à¡à¡à¡à¡à¡à¡à¡à¡à¡à¡à¡à¡à¡à¡à¡à¡à¡à¡à¡à¡à¡à¡à¡à¡à¡à¡à¡à¡à¡à¡à¡à¡à¡à¡à¡à¡à¡à¡à¡à¡à
¡à¡à¡à¡à¡à¡à¡à¡à¡à¡à¡à¡à¡à¡à¡à¡à¡à¡à¡à¡à¡à¡à¡à¡à¡à¡à¡à¡à¡à¡à¡à¡à¡à¡à¡à¡à¡à¡à¡à¡à¡à¡à¡à¡à¡à¡à¡à¡à¡à¡à¡à¡à¡à¡à¡à¡à¡à¡à¡à¡à¡à¡à¡à¡à¡à¡à¡à¡à¡à¡à¡à¡à¡à¡à¡à¡à¡à¡à¡à¡à¡à¡à¡à¡à¡à¡à¡à¡à¡à¡à¡à¡à¡à¡à¡à¡à¡à¡à¡à¡à
¡à¡à¡à¡à¡à¡à¡à¡à¡à¡à¡à¡à¡à¡à¡à¡à¡à¡à¡à¡à¡à¡à¡à¡à¡à¡à¡à¡à¡à¡à¡à¡à¡à¡à¡à¡à¡à¡à¡à¡à¡à¡à¡à¡à¡à¡à¡à¡à¡à¡à¡à¡à¡à¡à¡à¡à¡à¡à¡à¡à¡à¡à¡à¡à¡à¡à¡à¡à¡à¡à¡à¡à¡à¡à¡à¡à¡à¡à¡à¡à¡à¡à¡à¡à¡à¡à¡à¡à¡à¡à¡à¡à¡à¡à¡à¡à¡à¡à¡à¡à
¡à¡à¡à¡à¡à¡à¡à¡à¡à¡à¡à¡à¡à¡à¡à¡à¡à¡à¡à¡à¡à¡à¡à¡à¡à¡à¡à¡à¡à¡à¡à¡à¡à¡à¡à¡à¡à¡à¡à¡à¡à¡à¡à¡à¡à¡à¡à¡à¡à¡à¡à¡à¡à¡à¡à¡à¡à¡à¡à¡à¡à¡à¡à¡à¡à¡à¡à¡à¡à¡à¡à¡à¡à¡à¡à¡à¡à¡à¡à¡à¡à¡à¡à¡à¡à¡à¡à¡à¡à¡à¡à¡à¡à¡à¡à¡à¡à¡à¡à¡à
¡à¡à¡à¡à¡à¡à¡à¡à¡à¡à¡à¡à¡à¡à¡à¡à¡à¡à¡à¡à¡à¡à¡à¡à¡à¡à¡à¡à¡à¡à¡à¡à¡à¡à¡à¡à¡à¡à¡à¡à¡à¡à¡à¡à¡à¡à¡à¡à¡à¡à¡à¡à¡à¡à¡à¡à¡à¡à¡à¡à¡à¡à¡à¡à¡à¡à¡à¡à¡à¡à¡à¡à¡à¡à¡à¡à¡à¡à¡à¡à¡à¡à¡à¡à¡à¡à¡à¡à¡à¡à¡à¡à¡à¡à¡à¡à¡à¡à¡à¡à
¡à¡à¡à¡à¡à¡à¡à¡à¡à¡à¡à¡à¡à¡à¡à¡à¡à¡à¡à¡à¡à¡à¡à¡à¡à¡à¡à¡à¡à¡à¡à¡à¡à¡à¡à¡à¡à¡à¡à¡à¡à¡à¡à¡à¡à¡á¡á¡á¡á¡á¡á¡á¡á¡á¡á¡á¡á¡á¡á¡á¡á¡á¡á¡á¡á¡á¡á¡à¡à¡à¡à¡à¡à¡à¡à¡à¡à¡à¡à¡à¡à¡à¡à¡à¡à¡à¡à¡à¡à¡à¡à¡à¡à¡à¡à¡à¡à¡à¡à¡à
¡à¡à¡à¡à¡à¡à¡à¡à¡à¡à¡à¡à¡à¡à¡à¡à¡à¡à¡à¡à¡à¡à¡à¡à¡à¡à¡à¡à¡à¡à¡à¡à¡à¡à¡à¡à¡à¡à¡à¡à¡à¡à¡à¡à¡à¡à¡à¡à¡à¡à¡à¡à¡à¡à¡à¡à¡à¡à¡à¡à¡à¡à¡à¡à¡à¡à¡à¡à¡à¡à¡à¡à¡à¡à¡à¡à¡à¡à¡à¡à¡à¡à¡à¡à¡à¡à¡à¡à¡à¡à¡à¡à¡à¡à¡à¡à¡à¡à¡à¡à
¡à¡à¡à¡à¡à¡à¡à¡à¡à¡à¡à¡à¡à¡à¡à¡à¡à¡à¡à¡à¡à¡à¡à¡à¡à¡à¡à¡à¡à¡à¡à¡à¡à¡à¡à¡à¡à¡à¡à¡à¡à¡à¡à¡à¡à¡à¡à¡à¡à¡à¡à¡à¡à¡à¡à¡à¡à¡à¡à¡à¡à¡à¡à¡à¡à¡à¡à¡à¡à¡à¡à¡à¡à¡à¡à¡à¡à¡à¡à¡à¡à¡à¡à¡à¡à¡à¡à¡à¡à¡à¡à¡à¡à¡à¡à¡à¡à¡à¡à¡à
